#o---------P
#-#########-
#-#-------#-
#-#-#####-#-
#---#-----#-
###-#-#####-
E---#-------